6 14 14 12 12 14 14 10 6 10 
7 11 3 2 6 11 3 7 15 11 
7 11 5 11 7 15 15 11 3 1 
5 11 6 15 13 15 13 11 1 2 
6 13 13 15 14 13 14 15 10 3 
3 6 10 7 13 10 7 11 5 11 
7 15 13 15 8 5 13 15 14 11 
5 15 14 15 14 12 10 3 3 3 
6 9 7 9 7 12 15 13 13 11 
5 8 5 8 5 8 5 12 12 9 
