6 12 10 6 12 8 2 6 8 2 
1 4 13 13 14 12 15 11 6 11 
4 12 12 10 5 8 3 1 1 3 
6 8 2 5 10 6 13 8 6 9 
5 10 7 8 3 7 12 8 7 10 
6 15 9 4 11 7 10 2 3 3 
1 7 8 4 13 9 3 5 11 1 
6 9 6 12 10 6 13 12 13 8 
7 12 11 6 15 11 2 6 8 2 
5 8 1 1 1 5 13 13 12 9 
