6 8 4 12 14 8 6 8 6 12 8 2 6 8 2 
5 12 10 4 11 2 7 8 7 12 14 15 13 14 9 
4 14 11 2 3 5 15 8 1 2 1 5 10 1 2 
6 11 5 11 7 14 11 4 10 7 14 12 13 12 11 
3 1 2 7 11 1 5 12 15 11 5 12 14 8 1 
3 2 3 3 5 10 2 6 9 5 12 10 5 12 8 
7 13 9 3 4 13 11 3 4 12 10 1 6 10 2 
1 4 10 5 14 8 3 7 8 4 11 6 9 5 11 
2 6 9 4 13 10 1 5 8 6 13 9 2 4 9 
7 13 14 10 6 9 6 12 8 3 6 14 9 4 10 
3 2 1 7 13 12 15 12 12 15 9 7 8 2 3 
5 9 6 9 4 14 13 8 6 11 2 5 10 3 3 
4 14 15 10 2 3 2 4 11 1 7 12 13 13 11 
4 9 1 3 7 13 11 6 13 10 5 14 12 10 3 
4 12 12 9 1 4 9 1 4 13 8 5 8 1 1 
 _____________________________
|  _|___   _|  _|  ___| |  _| |
|___  |_  | |  _|  _     _   _|
|_    | | |_   _|_| |_|_  |_| |
|   |_  |     |_  |    _____  |
| |_| |   |_|___    |___   _|_|
| | | | |_  | |  _|___  |_____|
|  ___| |___  | |___  |_|   | |
|_|_  |_   _| |  _|_  |  _|_  |
| |  _|___  |_|___|  ___| |___|
|  _    |  _|  ___| |    _|_  |
| | |_|  ___   ___   _|  _| | |
|___|  _|_   ___|   | |_  | | |
|_      | | | |_  |_|  _____  |
|___|_| |  _  |  _  |_   _  | |
|_______|_|___|_|_____|___|_|_|
