4 10 2 6 12 8 6 12 14 10 
6 13 15 9 6 10 5 8 3 3 
1 6 15 14 9 5 14 14 11 1 
4 9 1 5 8 4 11 1 3 2 
4 14 12 12 8 2 1 4 15 9 
4 11 2 6 8 3 6 12 15 8 
4 13 11 3 4 15 13 8 3 2 
2 6 9 5 14 13 8 4 15 9 
7 13 14 10 3 4 10 6 13 10 
5 8 1 5 13 8 5 13 8 1 
 ___________________
|_  | |  ___|  _    |
|  _   _|   |___| | |
|_|      _|_      |_|
|___|_|___|_  |_| | |
|_   _____| |_|_   _|
|_  | |  _| |  _   _|
|___  | |_   ___| | |
| |  _|_   ___|_   _|
|  _    | |_  |  _  |
|___|_|_____|_____|_|
