6 12 8 2 6 12 14 8 2 2 4 14 12 14 10 4 10 
5 10 4 11 3 4 13 12 9 3 2 5 8 1 7 12 9 
2 5 12 15 15 12 8 6 14 15 11 6 12 12 11 6 8 
3 6 12 11 5 12 8 3 3 1 5 9 4 10 3 5 10 
3 5 8 7 12 8 6 11 1 6 8 4 14 9 5 14 9 
3 2 2 3 6 14 9 5 10 7 10 2 5 14 8 5 10 
3 5 13 13 11 5 10 2 1 3 5 13 14 11 2 4 9 
5 10 2 4 9 4 11 3 6 9 4 12 11 3 3 6 10 
6 11 7 14 12 12 9 5 15 12 8 4 11 1 7 11 1 
1 3 3 3 2 2 2 2 3 2 4 10 1 6 9 7 8 
2 5 11 1 5 13 15 11 7 13 12 11 6 11 6 9 2 
7 8 7 12 14 8 3 5 13 8 4 13 9 3 5 14 9 
7 12 13 10 7 12 11 2 6 12 10 6 10 7 8 1 2 
1 6 12 9 1 6 9 5 9 4 11 1 7 15 12 12 11 
6 11 2 2 2 3 4 14 10 6 13 8 3 3 6 8 1 
3 5 15 13 11 7 12 9 3 5 12 12 9 7 13 14 8 
1 4 9 4 9 5 12 8 5 12 12 12 8 1 4 13 8 
 _________________________________
|  ___| |  _   _| | |_   _    |_  |
|_  |_  | |_______| | |___|_|  ___|
| |___     ___|       |  ___  |  _|
| |  _  |_____| | |_|___|_  | |_  |
| |___|  ___|   |_|  _|_   _|_   _|
| | | | |    _|_  |   | |_   _|_  |
| |_____  |_  | |_| |___    | |___|
|_  | |___|_  | |  _|___  | | |   |
|   |    _____|_   ___|_  |_|   |_|
|_| | | | | | | | | |_  |_|  _|  _|
| |_  |_|___    |  ___  |   |  _| |
|  _|  _   _| |_____|_____| |_   _|
|  ___  |  _  | |  _  |   |  _|_| |
|_|  ___|_|  _|___|_  |_|    ___  |
|   | | | | |_    |  ___| | |  _|_|
| |_   _  |  ___| |_______|  _   _|
|_|___|___|_____|_________|_|_____|
