2 2 2 4 12 10 2 2 2 2 
5 15 11 4 10 3 7 13 15 9 
4 11 5 12 15 13 15 8 3 2 
6 9 6 8 1 4 9 4 13 11 
7 10 3 2 6 14 8 6 8 1 
3 7 15 13 9 5 12 13 10 2 
3 1 7 14 12 14 8 4 13 9 
1 2 3 3 2 5 12 14 12 8 
4 15 11 7 11 6 10 3 6 10 
4 9 1 1 1 1 5 13 9 1 
 ___________________
| | | |___  | | | | |
|_    |_  | |  _   _|
|_  |___   _   _| | |
|  _|  _|_|___|___  |
|   | | |    _|  _|_|
| |    ___|_____  | |
| |_|    _   _|_____|
|_| | | | |___   ___|
|_    |   |   | |   |
|___|_|_|_|_|_____|_|
