4 12 10 2 4 12 14 10 4 10 
6 10 5 15 8 6 9 3 4 11 
3 1 2 7 12 9 6 9 6 9 
3 2 3 5 14 10 5 12 15 10 
5 15 13 12 9 1 6 8 1 1 
6 13 14 8 2 2 7 8 4 10 
5 10 7 10 3 7 11 4 12 11 
6 9 1 7 13 11 1 4 10 3 
7 8 4 9 2 7 10 2 7 9 
5 12 12 12 9 1 5 13 13 8 
