4 14 12 12 10 6 8 6 12 8 
2 3 6 10 5 11 2 5 10 2 
3 3 3 3 2 7 13 12 15 9 
7 15 9 5 9 3 2 6 15 10 
3 1 6 12 12 11 5 9 1 1 
5 8 7 8 4 15 14 14 8 2 
2 4 13 8 2 3 1 5 8 3 
5 10 6 14 13 11 6 14 12 9 
4 15 9 3 6 15 11 5 12 10 
4 13 8 1 1 1 1 4 12 9 
 ___________________
|_   ___  |  _|  ___|
| | |   |_  | |_  | |
| | | | | |  ___   _|
|    _|___| | |     |
| |_|  ___  |___|_|_|
|___|  _|_       _| |
| |_____| | |_|___| |
|_  |    _  |    ___|
|_   _| |     |___  |
|_____|_|_|_|_|_____|
