6 10 2 6 8 6 8 2 2 2 
1 7 9 3 4 15 10 7 13 11 
6 9 4 11 2 3 5 13 8 3 
3 6 14 15 15 15 8 6 10 3 
5 11 3 1 1 7 10 1 7 9 
2 1 7 8 6 9 7 8 5 10 
3 2 3 6 13 10 3 4 10 3 
3 3 3 3 2 1 5 12 11 1 
5 13 9 3 7 12 12 8 7 8 
4 12 12 9 5 12 12 12 13 8 
