2 6 14 14 12 12 14 14 10 2 
5 15 15 15 12 12 15 13 13 11 
4 15 15 15 14 8 7 10 2 3 
4 15 11 3 5 12 11 5 11 1 
6 15 13 13 10 4 15 14 11 2 
3 7 10 6 11 2 7 15 15 11 
7 11 7 15 15 11 7 15 11 3 
7 11 5 11 3 7 15 11 5 11 
7 15 8 3 7 13 9 7 12 11 
5 9 4 13 13 8 4 13 12 9 
