2 6 8 2 2 2 4 10 4 10 
5 13 10 7 9 5 12 15 12 11 
4 14 11 5 14 8 2 3 4 11 
6 9 1 4 13 14 13 9 4 9 
5 14 12 10 2 5 14 8 6 8 
2 1 2 7 15 12 13 8 3 2 
7 12 11 1 7 8 4 14 13 9 
1 4 15 12 13 10 6 9 4 10 
6 12 11 6 10 7 15 10 6 11 
1 4 9 1 5 9 1 5 9 1 

 ___________________
| |  _| | | |_  |_  |
|___  |  _|___   _  |
|_    |_   _| | |_  |
|  _|_|___   ___|___|
|_   _  | |_   _|  _|
| |_| |    _____| | |
|  _  |_|  _|_   ___|
|_|_   ___  |  _|_  |
|  _  |   |     |   |
|_|___|_|___|_|___|_|
