6 12 12 10 4 14 14 12 14 14 10 
1 6 14 15 8 7 15 12 11 7 9 
6 15 11 1 4 15 11 2 3 3 2 
3 3 3 4 14 11 7 13 13 15 11 
7 13 15 14 11 5 15 14 10 3 3 
3 2 7 9 3 2 1 5 13 9 1 
1 3 7 14 9 7 8 6 12 8 2 
6 15 11 7 14 13 14 11 2 2 3 
5 15 15 15 15 12 9 1 3 7 9 
6 11 7 9 7 12 14 12 11 7 10 
1 5 13 8 1 4 13 12 13 13 9 
